FZDaLiTiS Regular	方正达利体简体
FZDaLiTiS-GB_Bold	方正达利体简体 Bold
FZDaLiTiS-GB_DemiBold	方正达利体简体 DemiBold
FZDaLiTiS-GB_ExtraBold	方正达利体简体 ExtraBold
FZDaLiTiS-GB_ExtraLight	方正达利体简体 ExtraLight
FZDaLiTiS-GB_Heavy	方正达利体简体 Heavy
FZDaLiTiS-GB_Light	方正达利体简体 Light
FZDaLiTiS-GB_Medium	方正达利体简体 Medium
FZDiHouTiS Regular	方正帝后体简体
FZDiHouTiS-GB_Bold	方正帝后体简体 Bold
FZDiHouTiS-GB_DemiBold	方正帝后体简体 DemiBold
FZDiHouTiS-GB_ExtraBold	方正帝后体简体 ExtraBold
FZDiHouTiS-GB_ExtraLight	方正帝后体简体 ExtraLight
FZDiHouTiS-GB_Heavy	方正帝后体简体 Heavy
FZDiHouTiS-GB_Light	方正帝后体简体 Light
FZDiHouTiS-GB_Medium	方正帝后体简体 Medium
FZFeiFanTiS Regular	方正非凡体简体
FZFeiFanTiS-GB_Bold	方正非凡体简体 Bold
FZFeiFanTiS-GB_DemiBold	方正非凡体简体 DemiBold
FZFeiFanTiS-GB_ExtraBold	方正非凡体简体 ExtraBold
FZFeiFanTiS-GB_Light	方正非凡体简体 Light
FZFeiFanTiS-GB_Medium	方正非凡体简体 Medium
FZHeiLiS Regular	方正黑隶简体
FZHeiLiS-B-GB	方正黑隶简体 Bold
FZHeiLiS-DB-GB	方正黑隶简体 DemiBold
FZHeiLiS-EB-GB	方正黑隶简体 ExtraBold
FZHeiLiS-EL-GB	方正黑隶简体 ExtraLight
FZHeiLiS-M-GB	方正黑隶简体 Medium
FZJPKTJW-GB1-0	方正精品楷体简体
FZQingChunTiS Regular	方正清纯体简体
FZQingChunTiS-GB_Bold	方正清纯体简体 Bold
FZQingChunTiS-GB_DemiBold	方正清纯体简体 DemiBold
FZQingChunTiS-GB_ExtraBold	方正清纯体简体 ExtraBold
FZQingChunTiS-GB_ExtraLight	方正清纯体简体 ExtraLight
FZQingChunTiS-GB_Heavy	方正清纯体简体 Heavy
FZQingChunTiS-GB_Light	方正清纯体简体 Light
FZQingChunTiS-GB_Medium	方正清纯体简体 Medium
FZRuiZhengHeiS Regular	方正锐正黑简体
FZRuiZhengHeiS-B-GB	方正锐正黑简体 Bold
FZRuiZhengHeiS-DB-GB	方正锐正黑简体 DemiBold
FZRuiZhengHeiS-EB-GB	方正锐正黑简体 ExtraBold
FZRuiZhengHeiS-EL-GB	方正锐正黑简体 ExtraLight
FZRuiZhengHeiS-M-GB	方正锐正黑简体 Medium
FZShuiYunS Regular	方正水云简体
FZShuiYunS-B-GB	方正水云简体 Bold
FZShuiYunS-DB-GB	方正水云简体 DemiBold
FZShuiYunS-EB-GB	方正水云简体 ExtraBold
FZShuiYunS-EL-GB	方正水云简体 ExtraLight
FZShuiYunS-M-GB	方正水云简体 Medium
FZYaZhuTiS Regular	方正雅珠体简体
FZYaZhuTiS-GB_Bold	方正雅珠体简体 Bold
FZYaZhuTiS-GB_DemiBold	方正雅珠体简体 DemiBold
FZYaZhuTiS-GB_ExtraBold	方正雅珠体简体 ExtraBold
FZYaZhuTiS-GB_ExtraLight	方正雅珠体简体 ExtraLight
FZYaZhuTiS-GB_Heavy	方正雅珠体简体 Heavy
FZYaZhuTiS-GB_Light	方正雅珠体简体 Light
FZYaZhuTiS-GB_Medium	方正雅珠体简体 Medium
FZYongKeTiS Regular	方正勇克体简体
FZYongKeTiS-GB_Bold	方正勇克体简体 Bold
FZYongKeTiS-GB_DemiBold	方正勇克体简体 DemiBold
FZYongKeTiS-GB_ExtraBold	方正勇克体简体 ExtraBold
FZYongKeTiS-GB_ExtraLight	方正勇克体简体 ExtraLight
FZYongKeTiS-GB_Heavy	方正勇克体简体 Heavy
FZYongKeTiS-GB_Light	方正勇克体简体 Light
FZYongKeTiS-GB_Medium	方正勇克体简体 Medium
