FZBangShuKaiT-R-GB	方正榜书楷繁体
FZBangShuXingT-R-GB	方正榜书行繁体
FZBaoSong-Z04T	方正报宋繁体
FZBeiWeiKaiShu-Z15T	方正北魏楷书繁体
FZBoYaFangKanSongT	方正博雅方刊宋繁体
FZBoYaKanSongT	方正博雅刊宋繁体
FZBoYaSongT-GB	方正博雅宋繁体
FZCaiYun-M09T	方正彩云繁体
FZChaoCuHei-M10T	方正超粗黑繁体
FZCuHei-B03T	方正粗黑繁体
FZCuHeiSongT-B-GB	方正粗黑宋繁体
FZCuHuoYi-M25T	方正粗活意繁体
FZCuQian-M17T	方正粗倩繁体
FZCuSong-B09T	方正粗宋繁体
FZCuYuan-M03T	方正粗圆繁体
FZDaBiaoSong-B06T	方正大标宋繁体
FZDaHei-B02T	方正大黑繁体
FZDengXianT-H-GB	方正粗等线繁体
FZFangSong-Z02T	方正仿宋繁体
FZFJKFW	方正佛经楷繁体
FZGuFangT-R-GB	方正古仿繁体
FZGuLi-S12T	方正古隶繁体
FZHaoTiT-R-GB	方正豪体繁体
FZHei-B01T	方正黑体繁体
FZHuaLi-M14T	方正华隶繁体
FZHuPo-M04T	方正琥珀繁体
FZJianZhi-M23T	方正剪纸繁体
FZJinLT-B-GB	方正粗金陵繁体
FZJinLT-L-GB	方正细金陵繁体
FZKai-Z03T	方正楷体繁体
FZKangTi-S07T	方正康体繁体
FZKaTong-M19T	方正卡通繁体
FZLanTingHeiT-B-GB	方正兰亭粗黑繁体
FZLanTingHeiT-DB1-GB	方正兰亭中粗黑繁体
FZLanTingHeiT-DB-GB	方正兰亭中黑繁体
FZLanTingHeiT-EB-GB	方正兰亭大黑繁体
FZLanTingHeiT-EL-GB	方正兰亭纤黑繁体
FZLanTingHeiT-HC-GB	方正兰亭特黑扁繁体
FZLanTingHeiT-H-GB	方正兰亭特黑繁体
FZLanTingHeiT-HN-GB	方正兰亭特黑长繁体
FZLanTingHeiT-L-GB	方正兰亭细黑繁体
FZLanTingHeiT-M-GB	方正兰亭准黑繁体
FZLanTingHeiT-RC-GB	方正兰亭黑扁繁体
FZLanTingHeiT-R-GB	方正兰亭黑繁体
FZLanTingHeiT-RN-GB	方正兰亭黑长繁体
FZLanTingHeiT-UL-GB	方正兰亭超细黑繁体
FZLanTingKanHeiT-R-GB	方正兰亭刊黑繁体
FZLanTingKanSongT	方正兰亭刊宋繁体
FZLanTingSongT-GB	方正兰亭宋繁体
FZLanTingYuanT-B-GB	方正兰亭圆繁体_粗
FZLanTingYuanT-DB1-GB	方正兰亭圆繁体_中粗
FZLanTingYuanT-DB-GB	方正兰亭圆繁体_中
FZLanTingYuanT-EB-GB	方正兰亭圆繁体_大
FZLanTingYuanT-EL-GB	方正兰亭圆繁体_纤
FZLanTingYuanT-H-GB	方正兰亭圆繁体_特
FZLanTingYuanT-L-GB	方正兰亭圆繁体_细
FZLanTingYuanT-M-GB	方正兰亭圆繁体_准
FZLanTingYuanT-R-GB	方正兰亭圆繁体
FZLiBian-S02T	方正隶变繁体
FZLiShuII-S06T	方正隶二繁体
FZLiShu-S01T	方正隶书繁体
FZLiuXingTi-M26T	方正流行体繁体
FZLongZhaoT-R-GB	方正龙爪繁体
FZLuXunTiT-R-GB	方正鲁迅繁体
FZMeiHei-M07T	方正美黑繁体
FZMiaoWuT-R-GB	方正喵呜繁体
FZNewKai-Z03T	方正新楷体繁体
FZNewShuSong-Z10T	方正新书宋繁体
FZNewShuTi-S08T	方正新舒体繁体
FZNewXiuLi-Z11T	方正新秀丽繁体
FZPangWa-M18T	方正胖娃繁体
FZPingHei-B04T	方正平黑繁体
FZPingHe-S11T	方正平和繁体
FZQiDiT-R-GB	方正启笛繁体
FZQiTi-S14T	方正启体繁体
FZShaErYingBiT-R-GB	方正莎儿硬笔繁体
FZShaoEr-M11T	方正少儿繁体
FZShouJinShu-S10T	方正瘦金书繁体
FZShuiHei-M21T	方正水黑繁体
FZShuiZhu-M08T	方正水柱繁体
FZShuSong-Z01T	方正书宋繁体
FZShuTi-S05T	方正舒体繁体
FZSongHei-B07T	方正宋黑繁体
FZSongKeBenXiuKaiT-R-GB	方正宋刻本秀楷繁体
FZSongYi-Z13T	方正宋一繁体
FZSuXinShiLiuKaiT-R-GB	方正苏新诗柳楷繁体
FZTanHeiT-B-GB	方正粗谭黑繁体
FZTanHeiT-L-GB	方正细谭黑繁体
FZTeCuGuangHuiT-R-GB	方正特粗光辉繁体
FZTieJinLiShu-Z14T	方正铁筋隶书繁体
FZTLFW	方正淘乐繁体
FZWeiBei-S03T	方正魏碑繁体
FZXiangLi-S17T	方正祥隶繁体
FZXiaoBiaoSong-B05T	方正小标宋繁体
FZXiaoZhuanTi-S13T	方正小篆体
FZXiDengXian-Z06T	方正细等线繁体
FZXiHeiI-Z08T	方正细黑一繁体
FZXingKai-S04T	方正行楷繁体
FZXiQian-M15T	方正细倩繁体
FZXiShanHu-M13T	方正细珊瑚繁体
FZXiYuan-M01T	方正细圆繁体
FZYaoTi-M06T	方正姚体繁体
FZYaSongT-BC-GB	方正粗雅宋扁繁体
FZYaSongT-B-GB	方正粗雅宋繁体
FZYaSongT-BN-GB	方正粗雅宋长繁体
FZYaSongT-DB1-GB	方正中粗雅宋繁体
FZYaSongT-DB-GB	方正中雅宋繁体
FZYaSongT-EB-GB	方正大雅宋繁体
FZYaSongT-EL-GB	方正纤雅宋繁体
FZYaSongT-H-GB	方正特雅宋繁体
FZYaSongT-L-GB	方正细雅宋繁体
FZYaSongT-M-GB	方正准雅宋繁体
FZYaSongT-R-GB	方正标雅宋繁体
FZYiHei-M20T	方正艺黑繁体
FZYingBiKaiShu-S15T	方正硬笔楷书繁体
FZYingBiXingShu-S16T	方正硬笔行书繁体
FZYingXueT-R-GB	方正萤雪繁体
FZYouHeiT 503L	方正悠黑繁体 503L
FZYouHeiT 504L	方正悠黑繁体 504L
FZYouHeiT 506L	方正悠黑繁体 506L
FZYouHeiT 508R	方正悠黑繁体 508R
FZYouHeiT 509R	方正悠黑繁体 509R
FZYouHeiT 510M	方正悠黑繁体 510M
FZYouHeiT 511M	方正悠黑繁体 511M
FZYouHeiT 512B	方正悠黑繁体 512B
FZYouHeiT 513B	方正悠黑繁体 513B
FZYouHeiT-B-GB	方正悠黑繁体_粗
FZYouHeiT-DB1-GB	方正悠黑繁体_中粗
FZYouHeiT-DB-GB	方正悠黑繁体_中
FZYouHeiT-EB-GB	方正悠黑繁体_大
FZYouHeiT-EL-GB	方正悠黑繁体_纤
FZYouHeiT-L1-GB	方正悠黑繁体_中细
FZYouHeiT-L-GB	方正悠黑繁体_细
FZYouHeiT-M-GB	方正悠黑繁体_准
FZYouHeiT-R-GB	方正悠黑繁体
FZYouXian-Z09T	方正幼线繁体
FZYueJinTiT-R-GB	方正跃进繁体
FZYunDongHeiT-B-GB	方正韵动粗黑繁体
FZYunDongHeiT-H-GB	方正韵动特黑繁体
FZYunDongHeiT-M-GB	方正韵动中黑繁体
FZZhanBiHei-M22T	方正毡笔黑繁体
FZZhangCaoT-R-GB	方正章草繁体
FZZhengHeiT-B-GB	方正正粗黑繁体
FZZhengHeiT-DB-GB	方正正中黑繁体
FZZhengHeiT-EB-GB	方正正大黑繁体
FZZhengHeiT-EL-GB	方正正纤黑繁体
FZZhengHeiT-M-GB	方正正准黑繁体
FZZhengHeiT-R-GB	方正正黑繁体
FZZhiYi-M12T	方正稚艺繁体
FZZhongDengXian-Z07T	方正中等线繁体
FZZhongKai-B08T	方正中楷繁体
FZZhongQian-M16T	方正中倩繁体
FZZhunYuan-M02T	方正准圆繁体
FZZJ-CJXSFW	方正字迹-长江行书繁体
FZZJ-DHTCSFW	方正字迹-杜慧田草书繁体
FZZJ-DLFW	方正字迹-栋隶繁体
FZZJ-DNXSFW	方正字迹-德年行书繁体
FZZJ-DYKTFW	方正字迹-典雅楷体繁体
FZZJ-DZDTFW	方正字迹-度知度体繁体
FZZJ-FOFW	方正字迹-仿欧繁体
FZZJ-FYFW	方正字迹-仿颜繁体
FZZJ-GBWKFW	方正字迹-钢笔伟楷繁体
FZZJ-GJKSFW	方正字迹-管峻楷书繁体
FZZJ-HFHWFW	方正字迹-鸿飞汉魏繁体
FZZJ-HFXSFW	方正字迹-豪放行书繁体
FZZJ-HJYBXCFW	方正字迹-洪俊硬笔行草繁体
FZZJ-JPJDFW	方正字迹-俊坡简牍繁体
FZZJ-KXFW	方正字迹-康行繁体
FZZJ-LFXSFW	方正字迹-黎凡行书繁体
FZZJ-LJDWBFW	方正字迹-吕建德魏碑繁体
FZZJ-LJDXKFW	方正字迹-吕建德行楷繁体
FZZJ-LTPGLFW	方正字迹－李太平根隶繁体
FZZJ-LYYBFW	方正字迹-刘郢硬笔繁体
FZZJ-MSHLFW	方正字迹-牟氏黑隶繁体
FZZJ-MSSLFW	方正字迹-牟氏瘦隶繁体
FZZJ-PANYBFW	方正字迹-佩安硬笔繁体
FZZJ-QDXKFW	方正字迹-启笛小楷繁体
FZZJ-TJHWBFW	方正字迹-陶建华魏碑繁体
FZZJ-TLFW	方正字迹-童佬繁体
FZZJ-WWGBXSFW	方正字迹-王伟钢笔行书繁体
FZZJ-XSLSFW	方正字迹-潇洒隶书繁体
FZZJ-XTCSFW	方正字迹-邢体草书繁体
FZZJ-XTLEFW	方正字迹-邢体隶二繁体
FZZJ-XTLYFW	方正字迹-邢体隶一繁体
FZZJ-XZJBFW	方正字迹-学贞简帛繁体
FZZJ-YCQJFW	方正字迹-彦辰清酒繁体
FZZJ-YTKLFW	方正字迹-元童楷隶繁体
FZZJ-ZCFW	方正字迹-张爨繁体
FZZJ-ZCQXZFW	方正字迹-周崇谦小篆繁体
FZZJ-ZHYBKTFW	方正字迹-张颢硬笔楷体繁体
FZZJ-ZNRXKFW	方正字迹-张乃仁行楷繁体
FZZJ-ZSCWBFW	方正字迹-张士超魏碑繁体
FZZJ-ZTGBXSFW	方正字迹-朱涛钢笔行书繁体
FZZJ-ZTMBZKFW	方正字迹- 朱涛毛笔正楷繁体
FZZJ-ZZGKTFW	方正字迹-曾正国楷体繁体
FZZJ-ZZGXKFW	方正字迹－曾正国行楷繁体
FZZongYi-M05T	方正综艺繁体
