DUANG	DUANG
FZBangShuKaiS-R-GB	方正榜书楷简体
FZBangShuXingS-R-GB	方正榜书行简体
FZBaoSong-Z04S	方正报宋简体
FZBeiWeiKaiShu-Z15S	方正北魏楷书简体
FZBingNanYuanSongS-R-GB	方正秉楠圆宋简体
FZBITMAPFENGJW	方正点阵冯简体
FZBoYaFangKanSongS	方正博雅方刊宋简体
FZBoYaKanSongS	方正博雅刊宋简体
FZBoYaSongS-GB	方正博雅宋简体
FZCaiYun-M09S	方正彩云简体
FZChaoCuHei-M10S	方正超粗黑简体
FZCuHeiSongS-B-GB	方正粗黑宋简体
FZCuHuoYi-M25S	方正粗活意简体
FZCuKaiS-R-GB	方正粗楷简体
FZCuQian-M17S	方正粗倩简体
FZCuSong-B09S	方正粗宋简体
FZCuYuan-M03S	方正粗圆简体
FZCuYuanSongS-R-GB	方正粗圆宋简体
FZDaBiaoSong-B06S	方正大标宋简体
FZDaCaoS-R-GB	方正大草简体
FZDaHei-B02S	方正粗黑简体
FZDaHei-B02S	方正大黑简体
FZDaWeiTiS-R-GB	方正大魏体简体
FZDengXianS-H-GB	方正粗等线简体
FZDeSaiHei125S-R-GB	方正德赛黑125简体
FZDeSaiHei515S-R-GB	方正德赛黑515简体
FZFangGuoTiS-R-GB	方正仿郭体简体
FZFangMeiS-R-GB	方正方魅简体
FZFangSong-Z02S	方正仿宋简体
FZFengYaSongS-GB	方正风雅宋简体
FZFenSTXS-R-GB	方正粉丝天下简体
FZFJKJW	方正佛经楷简体
FZGFShuSong	方正规范书宋
FZGongYHS-R-GB	方正工业黑简体
FZGuFangS-R-GB	方正古仿简体
FZGuLi-S12S	方正古隶简体
FZHanJianS-R-GB	方正汉简简体
FZHanZhenGuangBiaoS-GB	方正汉真广标简体
FZHaoGangQingTongTiS-R-GB	方正郝刚青铜体简体
FZHaoTiS-R-GB	方正豪体简体
FZHei-B01S	方正黑体简体
FZHeiLiS-B-GB	方正黑隶简体_粗
FZHeiLiS-DB-GB	方正黑隶简体_中
FZHeiLiS-EB-GB	方正黑隶简体_大
FZHeiLiS-EL-GB	方正黑隶简体_纤
FZHeiLiS-M-GB	方正黑隶简体_准
FZHeiLiS-R-GB	方正黑隶简体
FZHuaLi-M14S	方正华隶简体
FZHuangCao-S09S	方正黄草简体
FZHuPo-M04S	方正琥珀简体
FZJCXS	方正基础像素
FZJDJW	方正寂地简体
FZJianTiS-R-GB	方正剑体简体
FZJianZhi-M23S	方正剪纸简体
FZJingHeiShouXieS-R-GB	方正经黑手写简体
FZJingHeiS-R-GB	方正经黑简体
FZJingLeiS-R-GB	方正静蕾简体
FZJinLS-B-GB	方正粗金陵简体
FZJinLS-L-GB	方正细金陵简体
FZJPKai-Z03S	方正精品楷体简体
FZJPShuSong-Z01S	方正精品书宋简体
FZJunHeiS-B-GB	方正俊黑简体_粗
FZJunHeiS-DB-GB	方正俊黑简体_中
FZJunHeiS-EL-GB	方正俊黑简体_纤
FZJunHeiS-L-GB	方正俊黑简体_细
FZJunHeiS-M-GB	方正俊黑简体_准
FZJunHeiS-R-GB	方正俊黑简体
FZKai-Z03S	方正楷体简体
FZKangTi-S07S	方正康体简体
FZKaTong-M19S	方正卡通简体
FZKeBenFangSongS-R-GB	方正刻本仿宋简体
FZLanTingHeiS-B-GB	方正兰亭粗黑简体
FZLanTingHeiS-DB1-GB	方正兰亭中粗黑简体
FZLanTingHeiS-DB-GB	方正兰亭中黑简体
FZLanTingHeiS-EB-GB	方正兰亭大黑简体
FZLanTingHeiS-EL-GB	方正兰亭纤黑简体
FZLanTingHeiS-HC-GB	方正兰亭特黑扁简体
FZLanTingHeiS-H-GB	方正兰亭特黑简体
FZLanTingHeiS-HN-GB	方正兰亭特黑长简体
FZLanTingHeiS-L-GB	方正兰亭细黑简体
FZLanTingHeiS-M-GB	方正兰亭准黑简体
FZLanTingHeiS-RC-GB	方正兰亭黑扁简体
FZLanTingHeiS-R-GB	方正兰亭黑简体
FZLanTingHeiS-RN-GB	方正兰亭黑长简体
FZLanTingHeiS-UL-GB	方正兰亭超细黑简体
FZLanTingKanHeiS-R-GB	方正兰亭刊黑简体
FZLanTingKanSongS	方正兰亭刊宋简体
FZLanTingSongS-GB	方正兰亭宋简体
FZLanTingYuanS-B-GB	方正兰亭圆简体_粗
FZLanTingYuanS-DB1-GB	方正兰亭圆简体_中粗
FZLanTingYuanS-DB-GB	方正兰亭圆简体_中
FZLanTingYuanS-EB-GB	方正兰亭圆简体_大
FZLanTingYuanS-EL-GB	方正兰亭圆简体_纤
FZLanTingYuanS-H-GB	方正兰亭圆简体_特
FZLanTingYuanS-L-GB	方正兰亭圆简体_细
FZLanTingYuanS-M-GB	方正兰亭圆简体_准
FZLanTingYuanS-R-GB	方正兰亭圆简体
FZLiBian-S02S	方正隶变简体
FZLiShuII-S06S	方正隶二简体
FZLiShu-S01S	方正隶书简体
FZLiuXingTi-M26S	方正流行体简体
FZLongZhaoS-R-GB	方正龙爪简体
FZLuXunTiS-R-GB	方正鲁迅简体
FZMeiHei-M07S	方正美黑简体
FZMiaoWuS-R-GB	方正喵呜简体
FZMingShangTiS-R-GB	方正明尚简体
FZNewBaoSong-Z12S	方正新报宋简体
FZNewKai-Z03S	方正新楷体简体
FZNewShuSong-Z10S	方正新书宋简体
FZNewShuTi-S08S	方正新舒体简体
FZNHT	方正呐喊体
FZPangTouYu-M24S	方正胖头鱼简体
FZPangWa-M18S	方正胖娃简体
FZPingHe-S11S	方正平和简体
FZPinShangHeiS-B-GB	方正品尚粗黑简体
FZPinShangHeiS-DB-GB	方正品尚中黑简体
FZPinShangHeiS-EL-GB	方正品尚纤黑简体
FZPinShangHeiS-L-GB	方正品尚细黑简体
FZPinShangHeiS-M-GB	方正品尚准黑简体
FZPinShangHeiS-R-GB	方正品尚黑简体
FZPXJW	方正咆哮简体
FZQiDiS-R-GB	方正启笛简体
FZQingKeBenYueSongS-R-GB	方正清刻本悦宋简体
FZQingTongTiS-R-GB	方正青铜体简体
FZQiTi-S14S	方正启体简体
FZQuSongS-R-GB	方正趣宋简体
FZRuiShuiYunS-EB-GB	方正锐水云简体_大
FZRuiZhengHeiS-B-GB	方正锐正黑简体_粗
FZRuiZhengHeiS-DB-GB	方正锐正黑简体_中
FZRuiZhengHeiS-EB-GB	方正锐正黑简体_大
FZRuiZhengHeiS-EL-GB	方正锐正黑简体_纤
FZRuiZhengHeiS-M-GB	方正锐正黑简体_准
FZRuiZhengHeiS-R-GB	方正锐正黑简体
FZRunBianSongS-R-GB	方正润扁宋简体
FZShaErYingBiS-R-GB	方正莎儿硬笔简体
FZShangKuS-R-GB	方正尚酷简体
FZShaoEr-M11S	方正少儿简体
FZShengShiKaiShuS-B-GB	方正盛世楷书简体_粗
FZShengShiKaiShuS-DB-GB	方正盛世楷书简体_中
FZShengShiKaiShuS-EB-GB	方正盛世楷书简体_大
FZShengShiKaiShuS-EL-GB	方正盛世楷书简体_纤
FZShengShiKaiShuS-M-GB	方正盛世楷书简体_准
FZShengShiKaiShuS-R-GB	方正盛世楷书简体
FZShouHuiS-B-GB	方正手绘简体_粗
FZShouHuiS-L-GB	方正手绘简体_细
FZShouHuiS-M-GB	方正手绘简体_准
FZShouHuiS-R-GB	方正手绘简体
FZShouJinShu-S10S	方正瘦金书简体
FZShuiHei-M21S	方正水黑简体
FZShuiYunS-B-GB	方正水云简体_粗
FZShuiYunS-DB-GB	方正水云简体_中
FZShuiYunS-EB-GB	方正水云简体_大
FZShuiYunS-EL-GB	方正水云简体_纤
FZShuiYunS-M-GB	方正水云简体_准
FZShuiYunS-R-GB	方正水云简体
FZShuiZhu-M08S	方正水柱简体
FZShuSong-Z01S	方正书宋简体
FZShuTi-S05S	方正舒体简体
FZSongHei-B07S	方正宋黑简体
FZSongIII-Z05S	方正宋三简体
FZSongKeBenXiuKaiS-R-GB	方正宋刻本秀楷简体
FZSongYi-Z13S	方正宋一简体
FZSSBJW	方正四岁半简体
FZSunYongShengS-R-GB	方正孙拥声简体
FZSuXinShiLiuKaiS-R-GB	方正苏新诗柳楷简体
FZSuXinShiYiBiao-R-GB	方正苏新诗艺标简体
FZTanHeiS-B-GB	方正粗谭黑简体
FZTanHeiS-L-GB	方正细谭黑简体
FZTeCuGuangHuiS-R-GB	方正特粗光辉简体
FZTieJinLiShu-S17S	方正铁筋隶书简体
FZTLJW	方正淘乐简体
FZVECTORFENGJW	方正矢量冯简体
FZWeiBei-S03S	方正魏碑简体
FZXBXYWST	方正徐冰新英文书体
FZXiangLi-S17S	方正祥隶简体
FZXianRenS-R-GB	方正显仁简体
FZXiaoBiaoSong-B05S	方正小标宋简体
FZXiDengXian-Z06S	方正细等线简体
FZXiHeiI-Z08S	方正细黑一简体
FZXingHeiS-R-GB	方正行黑简体
FZXingKai-S04S	方正行楷简体
FZXiQian-M15S	方正细倩简体
FZXiShanHu-M13S	方正细珊瑚简体
FZXiYuan-M01S	方正细圆简体
FZXS12	方正像素12
FZXS14	方正像素14
FZXS15	方正像素15
FZXS16	方正像素16
FZXS18	方正像素18
FZXS24	方正像素24
FZXuanZhenZhuanBianS-R-GB	方正悬针篆变简体
FZYanSongS-B-GB	方正颜宋简体_粗
FZYanSongS-DB-GB	方正颜宋简体_中
FZYanSongS-EB-GB	方正颜宋简体_大
FZYanSongS-EL-GB	方正颜宋简体_纤
FZYanSongS-M-GB	方正颜宋简体_准
FZYanSongS-R-GB	方正颜宋简体
FZYaoTi-M06S	方正姚体简体
FZYaSongS-BC-GB	方正粗雅宋扁简体
FZYaSongS-B-GB	方正粗雅宋简体
FZYaSongS-BN-GB	方正粗雅宋长简体
FZYaSongS-DB1-GB	方正中粗雅宋简体
FZYaSongS-DB-GB	方正中雅宋简体
FZYaSongS-EB-GB	方正大雅宋简体
FZYaSongS-EL-GB	方正纤雅宋简体
FZYaSongS-H-GB	方正特雅宋简体
FZYaSongS-L-GB	方正细雅宋简体
FZYaSongS-M-GB	方正准雅宋简体
FZYaSongS-R-GB	方正标雅宋简体
FZYiHei-M20S	方正艺黑简体
FZYingBiKaiShu-S15S	方正硬笔楷书简体
FZYingBiXingShu-S16S	方正硬笔行书简体
FZYingXueS-R-GB	方正萤雪简体
FZYouHeiS 501L	方正悠黑简体 501L
FZYouHeiS 502L	方正悠黑简体 502L
FZYouHeiS 503L	方正悠黑简体 503L
FZYouHeiS 504L	方正悠黑简体 504L
FZYouHeiS 506L	方正悠黑简体 506L
FZYouHeiS 508R	方正悠黑简体 508R
FZYouHeiS 509R	方正悠黑简体 509R
FZYouHeiS 510M	方正悠黑简体 510M
FZYouHeiS 511M	方正悠黑简体 511M
FZYouHeiS 512B	方正悠黑简体 512B
FZYouHeiS 513B	方正悠黑简体 513B
FZYouHeiS-B-GB	方正悠黑简体_粗
FZYouHeiS-DB1-GB	方正悠黑简体_中粗
FZYouHeiS-DB-GB	方正悠黑简体_中
FZYouHeiS-EB-GB	方正悠黑繁体_大
FZYouHeiS-EL-GB	方正悠黑简体_纤
FZYouHeiS-L1-GB	方正悠黑简体_中细
FZYouHeiS-L-GB	方正悠黑简体_细
FZYouHeiS-M-GB	方正悠黑简体_准
FZYouHeiS-R-GB	方正悠黑简体
FZYouHeiS-UL1-GB	方正悠黑简体_精细
FZYouHeiS-UL-GB	方正悠黑简体_超细
FZYouMaoZaiS-R-GB	方正有猫在简体
FZYouXian-Z09S	方正幼线简体
FZYueJinTiS-R-GB	方正跃进简体
FZYunDongHeiS-B-GB	方正韵动粗黑简体
FZYunDongHeiS-H-GB	方正韵动特黑简体
FZYunDongHeiS-M-GB	方正韵动中黑简体
FZYuNuS-R-GB	方正羽怒简体
FZZangYiHanTiS-R-GB	方正藏意汉体简体
FZZhanBiHei-M22S	方正毡笔黑简体
FZZhangCaoS-R-GB	方正章草简体
FZZhengHeiS-B-GB	方正正粗黑简体
FZZhengHeiS-DB-GB	方正正中黑简体
FZZhengHeiS-EB-GB	方正正大黑简体
FZZhengHeiS-EL-GB	方正正纤黑简体
FZZhengHeiS-M-GB	方正正准黑简体
FZZhengHeiS-R-GB	方正正黑简体
FZZhiYi-M12S	方正稚艺简体
FZZhongDengXian-Z07S	方正中等线简体
FZZhongQian-M16S	方正中倩简体
FZZhunYuan-M02S	方正准圆简体
FZZJ-BLYBJW	方正字迹-百乐硬笔简体
FZZJ-BQKSJW	方正字迹-柏求楷书简体
FZZJ-CDMXKJW	方正字迹-陈代明行楷简体
FZZJ-CJXSJW	方正字迹-长江行书简体
FZZJ-DHTCSJW	方正字迹-杜慧田草书简体
FZZJ-DHTMBJW	方正字迹-杜慧田毛笔简体
FZZJ-DHTMBKSJW	方正字迹-杜慧田毛笔楷书简体
FZZJ-DHTYBJW	方正字迹-杜慧田硬笔简体
FZZJ-DHTYBKSJW	方正字迹-杜慧田硬笔楷书简体
FZZJ-DLJW	方正字迹-栋隶简体
FZZJ-DNXSJW	方正字迹-德年行书简体
FZZJ-DYKTJW	方正字迹-典雅楷体简体
FZZJ-DZDTJW	方正字迹-度知度体简体
FZZJ-FJBZJW	方正字迹-佛君包装简体
FZZJ-FJCJW	方正字迹-冯金城简体
FZZJ-FOJW	方正字迹-仿欧简体
FZZJ-FYJW	方正字迹-仿颜简体
FZZJ-GBWKJW	方正字迹-钢笔伟楷简体
FZZJ-GJKSJW	方正字迹-管峻楷书简体
FZZJ-HFHWJW	方正字迹-鸿飞汉魏简体
FZZJ-HFXSJW	方正字迹-豪放行书简体
FZZJ-HJYBXCJW	方正字迹-洪俊硬笔行草简体
FZZJ-JPJDJW	方正字迹-俊坡简牍简体
FZZJ-KXJW	方正字迹-康行简体
FZZJ-LFXSJW	方正字迹-黎凡行书简体
FZZJ-LJDWBJW	方正字迹-吕建德魏碑简体
FZZJ-LJDXKJW	方正字迹-吕建德行楷简体
FZZJ-LPYBJW	方正字迹—老潘硬笔简体
FZZJ-LTPGLJW	方正字迹－李太平根隶简体
FZZJ-LYYBJW	方正字迹-刘郢硬笔简体
FZZJ-LYYBKSJW	方正字迹-刘毅硬笔楷书简体
FZZJ-LYYBXSJW	方正字迹-刘毅硬笔行书简体
FZZJ-MSHLJW	方正字迹-牟氏黑隶简体
FZZJ-MSSLJW	方正字迹-牟氏瘦隶简体
FZZJ-PANYBJW	方正字迹-佩安硬笔简体
FZZJ-QDXKJW	方正字迹-启笛小楷简体
FZZJ-QSCSJSJW	方正字迹-邱氏粗瘦金书简体
FZZJ-SHXSJW	方正字迹-四海行书简体
FZZJ-TJHWBJW	方正字迹-陶建华魏碑简体
FZZJ-TLJW	方正字迹-童佬简体
FZZJ-TTMBJW	方正字迹-童体毛笔简体
FZZJ-TTYBJW	方正字迹-童体硬笔简体
FZZJ-WWGBXSJW	方正字迹-王伟钢笔行书简体
FZZJ-XSLSJW	方正字迹-潇洒隶书简体
FZZJ-XSS	方正字迹-新手书
FZZJ-XTCSJW	方正字迹-邢体草书简体
FZZJ-XTLEJW	方正字迹-邢体隶二简体
FZZJ-XTLYJW	方正字迹-邢体隶一简体
FZZJ-XZJBJW	方正字迹-学贞简帛简体
FZZJ-YCQJJW	方正字迹-彦辰清酒简体
FZZJ-YGYTKJW	方正字迹-叶根友特楷简体
FZZJ-YTKLJW	方正字迹-元童楷隶简体
FZZJ-ZBQPBJW	方正字迹-曾柏求排笔简体
FZZJ-ZBQWBJW	方正字迹-曾柏求魏碑简体
FZZJ-ZBQXKJW	方正字迹-曾柏求行楷简体
FZZJ-ZBQYBJW	方正字迹-曾柏求硬笔简体
FZZJ-ZCJW	方正字迹-张爨简体
FZZJ-ZCQXZJW	方正字迹-周崇谦小篆简体
FZZJ-ZHYBKTJW	方正字迹-张颢硬笔楷体简体
FZZJ-ZLYBXSJW	方正字迹-张亮硬笔行书简体
FZZJ-ZNRXKJW	方正字迹-张乃仁行楷简体
FZZJ-ZSCWBJW	方正字迹-张士超魏碑简体
FZZJ-ZSXKJW	方正字迹-子实行楷简体
FZZJ-ZTGBXSJW	方正字迹-朱涛钢笔行书简体
FZZJ-ZTMBZKJW	方正字迹- 朱涛毛笔正楷简体
FZZJ-ZYWBJW	方正字迹-志勇魏碑简体
FZZJ-ZZGKTJW	方正字迹-曾正国楷体简体
FZZJ-ZZGXKJW	方正字迹-曾正国行楷简体
FZZK	方正字酷
FZZongYi-M05S	方正综艺简体
LSLT-8456	指尖隶书体
LSSST-1498	凌氏随手体
MO8JW	墨八岁简体
QFKT	求福楷体
SJNMDJW	世界那么大
TTChaoHei-B03S	体坛超黑简体
TTCuHei-B02S	体坛粗黑简体
ZKT-3151	龙龙秀楷体
方正藏体简体	方正藏体简体
