FZBaoSong-Z04	方正报宋_GBK
FZBeiWeiKaiShu-S19	方正北魏楷书_GBK
FZBoYaFangKanSongK	方正博雅方刊宋_GBK
FZBoYaKanSongK	方正博雅刊宋_GBK
FZBoYaSong	方正博雅宋_GBK
FZCaiYun-M09	方正彩云_GBK
FZChaoCuHei-M10	方正超粗黑_GBK
FZCuHuoYi-M25	方正粗活意_GBK
FZCuQian-M17	方正粗倩_GBK
FZCuSong-B09	方正粗宋_GBK
FZCuYuan-M03	方正粗圆_GBK
FZDaBiaoSong-B06	方正大标宋_GBK
FZDaHei-B02	方正大黑_GBK
FZDengXian-H-GBK	方正粗等线_GBK
FZFangSong-Z02	方正仿宋_GBK
FZGuLi-S12	方正古隶_GBK
FZHei-B01	方正黑体_GBK
FZHuaLi-M14	方正华隶_GBK
FZHuangCao-S09	方正黄草_GBK
FZHuPo-M04	方正琥珀_GBK
FZJianZhi-M23	方正剪纸_GBK
FZKai-Z03	方正楷体_GBK
FZKangTi-S07	方正康体_GBK
FZKaTong-M19	方正卡通_GBK
FZLanTingHei-B-GBK	方正兰亭粗黑_GBK
FZLanTingHei-DB-GBK	方正兰亭中黑_GBK
FZLanTingHei-EB-GBK	方正兰亭大黑_GBK
FZLanTingHei-EL-GBK	方正兰亭纤黑_GBK
FZLanTingHei-HC-GBK	方正兰亭特黑扁_GBK
FZLanTingHei-H-GBK	方正兰亭特黑_GBK
FZLanTingHei-HN-GBK	方正兰亭特黑长_GBK
FZLanTingHei-L-GBK	方正兰亭细黑_GBK
FZLanTingHei-M-GBK	方正兰亭准黑_GBK
FZLanTingHei-RC-GBK	方正兰亭黑扁_GBK
FZLanTingHei-R-GBK	方正兰亭黑_GBK
FZLanTingHei-RN-GBK	方正兰亭黑长_GBK
FZLanTingHeiS-DB1-GBK	方正兰亭中粗黑_GBK
FZLanTingHei-UL-GBK	方正兰亭超细黑_GBK
FZLanTingKanHei-R-GBK	方正兰亭刊黑_GBK
FZLanTingKanSongK	方正兰亭刊宋_GBK
FZLanTingSong	方正兰亭宋_GBK
FZLanTingYuan-B-GBK	方正兰亭圆_GBK_粗
FZLanTingYuan-DB1-GBK	方正兰亭圆_GBK_中粗
FZLanTingYuan-DB-GBK	方正兰亭圆_GBK_中
FZLanTingYuan-EB-GBK	方正兰亭圆_GBK_大
FZLanTingYuan-EL-GBK	方正兰亭圆_GBK_纤
FZLanTingYuan-H-GBK	方正兰亭圆_GBK_特
FZLanTingYuan-L-GBK	方正兰亭圆_GBK_细
FZLanTingYuan-M-GBK	方正兰亭圆_GBK_准
FZLanTingYuan-R-GBK	方正兰亭圆_GBK
FZLiBian-S02	方正隶变_GBK
FZLiShuII-S06	方正隶二_GBK
FZLiShu-S01	方正隶书_GBK
FZLiuXingTi-M26	方正流行体_GBK
FZLuXunTi-R-JF	方正鲁迅体简繁
FZMeiHei-M07	方正美黑_GBK
FZMiaoWu-GBK	方正喵呜_GBK
FZMiaoWu-GBK	方正有猫在_GBK
FZNewBaoSong-Z12	方正新报宋_GBK
FZNewKai-Z03	方正新楷体_GBK
FZNewShuSong-Z10	方正新书宋_GBK
FZNewShuTi-S08	方正新舒体_GBK
FZPangTouYu-M24	方正胖头鱼_GBK
FZPangWa-M18	方正胖娃_GBK
FZPingHe-S11	方正平和_GBK
FZQiTi-S14	方正启体_GBK
FZShaoEr-M11	方正少儿_GBK
FZShouJinShu-S10	方正瘦金书_GBK
FZShuiHei-M21	方正水黑_GBK
FZShuiZhu-M08	方正水柱_GBK
FZShuSong-Z01	方正书宋_GBK
FZShuTi-S05	方正舒体_GBK
FZSongHei-B07	方正宋黑_GBK
FZSongIII-Z05	方正宋三_GBK
FZSongKeBenXiuKai-R-GBK	方正宋刻本秀楷_GBK
FZSongYi-Z13	方正宋一_GBK
FZTieJinLiShu-S17	方正铁筋隶书_GBK
FZWeiBei-S03	方正魏碑_GBK
FZXiangLi-S17	方正祥隶_GBK
FZXiaoBiaoSong-B05	方正小标宋_GBK
FZXiaoZhuanTi-S13	方正小篆体_GBK
FZXiDengXian-Z06	方正细等线_GBK
FZXiHeiI-Z08	方正细黑一_GBK
FZXingKai-S04	方正行楷_GBK
FZXiQian-M15	方正细倩_GBK
FZXiShanHu-M13	方正细珊瑚_GBK
FZXiYuan-M01	方正细圆_GBK
FZYaoTi-M06	方正姚体_GBK
FZYaSong-BC-GBK	方正粗雅宋扁_GBK
FZYaSong-B-GBK	方正粗雅宋_GBK
FZYaSong-BN-GBK	方正粗雅宋长_GBK
FZYaSong-DB1-GBK	方正中粗雅宋_GBK
FZYaSong-DB-GBK	方正中雅宋_GBK
FZYaSong-EB-GBK	方正大雅宋_GBK
FZYaSong-EL-GBK	方正纤雅宋_GBK
FZYaSong-H-GBK	方正特雅宋_GBK
FZYaSong-L-GBK	方正细雅宋_GBK
FZYaSong-M-GBK	方正准雅宋_GBK
FZYaSong-R-GBK	方正标雅宋_GBK
FZYiHei-M20	方正艺黑_GBK
FZYingBiKaiShu-S15	方正硬笔楷书_GBK
FZYingBiXingShu-S16	方正硬笔行书_GBK
FZYouH_GBK 503L	方正悠黑_GBK 503L
FZYouH_GBK 504L	方正悠黑_GBK 504L
FZYouH_GBK 506L	方正悠黑_GBK 506L
FZYouH_GBK 508R	方正悠黑_GBK 508R
FZYouHei_GBK 509R	方正悠黑_GBK 509R
FZYouHei_GBK 510M	方正悠黑_GBK 510M
FZYouHei_GBK 511M	方正悠黑_GBK 511M
FZYouHei_GBK 512B	方正悠黑_GBK 512B
FZYouHei_GBK 513B	方正悠黑_GBK 513B
FZYouHei-B-GBK	方正悠黑_GBK_粗
FZYouHei-DB1-GBK	方正悠黑_GBK_中粗
FZYouHei-DB-GBK	方正悠黑_GBK_中
FZYouHei-EB-GBK	方正悠黑_GBK_大
FZYouHei-EL-GBK	方正悠黑_GBK_纤
FZYouHei-L1-GBK	方正悠黑_GBK_中细
FZYouHei-L-GBK	方正悠黑_GBK_细
FZYouHei-M-GBK	方正悠黑_GBK_准
FZYouHei-R-GBK	方正悠黑_GBK
FZYouXian-Z09	方正幼线_GBK
FZYueJinTi-R-GBK	方正跃进体_GBK
FZYunDongHei-B-GBK	方正韵动粗黑_GBK
FZYunDongHei-H-GBK	方正韵动特黑_GBK
FZYunDongHei-M-GBK	方正韵动中黑_GBK
FZZhanBiHei-M22	方正毡笔黑_GBK
FZZhengHei-B-GBK	方正正粗黑_GBK
FZZhengHei-DB-GBK	方正正中黑_GBK
FZZhengHei-EB-GBK	方正正大黑_GBK
FZZhengHei-EL-GBK	方正正纤黑_GBK
FZZhengHei-M-GBK	方正正准黑_GBK
FZZhengHei-R-GBK	方正正黑_GBK
FZZhiYi-M12	方正稚艺_GBK
FZZhongDengXian-Z07	方正中等线_GBK
FZZhongQian-M16	方正中倩_GBK
FZZhunYuan-M02	方正准圆_GBK
FZZongYi-M05	方正综艺_GBK
